1111111111111111111
1E00000000000000001
1010010100100000101
101001001C101010001
1P00000000000000001
1111111111111111111